ά̓	á̓
ἰ	i
ἷ̓	hî̓
ὠ	ō
β̓	b̓
ψ̓	ps̓
τ̓	t̓
ῷ̓	ôi̓
ῦ̓	û̓
ὐ	u
ό̓	ó̓
λ̓	l̓
ἠ	ē
ὀ	o
ῤ̓	r̓
ἀ	a
ῶ̓	ô̓
έ̓	é̓
ῖ̓	î̓
χ̓	kh̓
γ̓	g̓
κ̓	k̓
φ̓	ph'
ν̓	n̓
ῥ̓	hr̓
π̓	p̓
ῤ	r
ϊ̓	ï̓
ζ̓	z̓
ύ̓	ú̓
ῆ̓	ê̓
ξ̓	x̓
σ̓	s̓
μ̓	m̓
θ̓	th̓
ʽ̓	ʽ̓
Π́	P̓
Αἵ	Haí
εὑ	heu
εὗ	heû
εἵ	heí
εἷ	heî
αἷ	haî
οἱ	hoi
οὑ	hou
αἳ	haì
οὓ	hoù
οἷ	hoî
οἵ	hoí
αἱ	hai
αἵ	haí
οἳ	hoì
οὗ	hoû
ὀ͂	ô
εἱ	hei
π͂	p̂
Αἱ	Hai
υἷ	huî
ψ́	ps̓
ί̓	í̓
ἐ	e
δ̓	d̓
υἱ	hui
ἵ	hí
Ἑ	He
Α	A
ἧ	hê
Γ	G
ἅ	há
Ξ	X
Ζ	Z
ἃ	hà
ῢ	ǜ
ἷ	hî
Ἰ	I
ᾗ	hêi
Ἕ	Hé
Ν	N
Ἐ	E
Β	B
Ε	E
ἆ	â
ᾠ	ōi
Ἠ	Ē
Ὄ	Ó
Ὠ	Ō
Μ	M
ὓ	hù
ῄ	ḗi
Ῥ	R
Ὕ	Hú
ᾴ	ái
ῂ	ḕi
Ἅ	Há
Ὡ	Hō
ᾕ	hḗi
Ἦ	Ê
Ὤ	Ṓ
ᾦ	ôi
Ἆ	Â
ϝ	v
ἒ	è
ᾑ	hēi
ἔ	é
Ψ	Ps
´	́
?	?
ῗ	ï̂
Ἁ	Ha
Ὥ	Hṓ
Ἱ	Hi
ἲ	ì
Ἔ	É
ᾐ	ēi
Ἶ	Î
Ὧ	Hô
Ὦ	Ô
Ὑ	Hu
ᾳ	ai
Ἤ	Ḗ
Ἡ	Hē
ᾖ	êi
ὢ	ṑ
῞	h́
ἓ	hè
῎	́
ᾍ	Hái
~	̂
ὶ	ì
ἑ	he
ὲ	è
ὺ	ù
τ	t
ώ	ṓ
ἡ	hē
ΐ	ḯ
ψ	ps
ί	í
φ	ph
ἰ	i
ῦ	û
ύ	ú
σ	s
ἀ	a
ῶ	ô
ὴ	ḕ
ὗ	hû
ξ	x
ή	ḗ
β	b
ἐ	e
ὸ	ò
Δ	D
ᾶ	â
π	p
κ	k
γ	g
λ	l
η	ē
Π	P
ὰ	à
θ	th
δ	d
ε	e
ἄ	á
ι	i
ν	n
ῆ	ê
ϊ	ï
ά	á
ω	ō
ῖ	î
α	a
ρ	r
υ	u
ἣ	hḕ
έ	é
ὐ	u
ς	s
ο	o
χ	kh
Ἀ	A
μ	m
Λ	L
ὧ	hô
ῥ	hr
ὅ	hó
Ἥ	Hḗ
ῇ	êi
ᾤ	ṓi
ῴ	ṓi
ἕ	hé
ἤ	ḗ
ὤ	ṓ
Ο	O
Φ	Ph
ὁ	ho
ἳ	hì
ὠ	ō
ὡ	hō
ὔ	ú
ᾧ	hôi
ῒ	ï̀
ὦ	ô
Ἴ	Í
ΰ	ǘ
ᾔ	ḗi
Θ	Th
ᾷ	âi
ἂ	à
Σ	S
ἶ	î
Τ	T
ὑ	hu
ϋ	ü
ῳ	ōi
ἦ	ê
ἠ	ē
Χ	Kh
ὕ	hú
ὀ	o
ὄ	ó
ὃ	hò
ό	ó
Ὀ	O
ὖ	û
ἴ	í
Κ	K
ὣ	hṑ
ὥ	hṓ
Ἄ	Á
ἢ	ḕ
ὼ	ṑ
ῷ	ôi
ἥ	hḗ
ῃ	ēi
ζ	z
ἁ	ha
ἱ	hi
