μ	m
ῆ	ê
ν	n
ι	i
ἄ	á
ε	e
δ	d
θ	th
ὰ	à
Π	P
η	ē
λ	l
ϊ	ï
ά	á
ω	ō
Ἀ	A
χ	kh
ο	o
ς	s
ὐ	u
έ	é
ἣ	hḕ
υ	u
ρ	r
ί̓	í̓
α	a
ῖ	î
γ	g
ἐ	e
ἔ	é
κ	k
π	p
δ̓	d̓
ἰ	i
φ	ph
ί	í
ψ	ps
ΐ	ḯ
ἡ	hē
ώ	ṓ
τ	t
ὺ	ù
ὲ	è
ἑ	he
ῦ	û
ύ	ú
σ	s
ᾶ	â
Δ	D
ὸ	ò
ἐ	e
β	b
ή	ḗ
ξ	x
ὗ	hû
ὴ	ḕ
ῶ	ô
ἀ	a
ὶ	ì
τ̓	t̓
Λ	L
ἱ	hi
ό	ó
ὃ	hò
ὄ	ó
ὀ	o
ὕ 	hú
Χ	Kh
ἠ	ē
ἦ	ê
ἰ	i
ῳ	ōi
ϋ	ü
ὑ	hu
Ὀ	O
ὖ	û
ἴ	í
ἁ	ha
ζ	z
θ̓	th̓
λ̓	l̓
ῃ	ēi
ἥ	hḗ
ῷ	ôi
ὼ	ṑ
ἢ	ḕ
Ἄ	Á
μ̓	m̓
ὥ	hṓ
ὣ	hṑ
ΰ	ǘ
ξ̓	x̓
Κ	K
Τ	T
ἶ	î
Σ	S
Φ	Ph
Ο	O
ὤ	ṓ
ῤ	r
π̓	p̓
ἤ	ḗ
ἕ	hé
ῴ	ṓi
ᾤ	ṓi
ῇ	êi
Ἥ	Hḗ
ὅ	hó
ῥ	hr
ὁ	ho
ἳ	hì
ὠ	ō
ἂ	à
ᾷ	âi
κ̓	k̓
γ̓	g̓
Θ	Th
χ̓	kh̓
ᾔ	ḗi
σ̓	s̓
Ἴ	Í
ὦ	ô
ῒ	ï̀
ᾧ	hôi
ὔ	ú
ὡ	hō
ά̓	á̓
ὧ	hô
Ζ	Z
ἧ	hê
Α	A
ἵ	hí
ἅ	há
ἷ	hî
Ἰ	I
Μ	M
Β	B
ῢ	ǜ
ᾗ	hêi
φ̓	ph'
Ἕ	Hé
Ν	N
Ἐ	E
ν̓	n̓
Ε	E
ἆ	â
ᾠ	ōi
Ἠ	Ē
Ὄ	Ó
Ὠ	Ō
ῥ̓	hr̓
ϊ̓	ï̓
ζ̓	z̓
Ἑ	He
Γ	G
ὓ	hù
ύ̓	ú̓
ῆ̓	ê̓
ἃ	hà
ῄ	ḗi
Ῥ	R
Ἱ	Hi
ἲ	ì
Ἔ	É
ᾐ	ēi
Ἶ	Î
ῖ̓	î̓
Ὦ	Ô
Ὑ	Hu
ᾳ	ai
Ἤ	Ḗ
έ̓	é̓
Ἡ	Hē
Ξ	X
ᾖ	êi
ὢ	ṑ
ἷ̓	hî̓
ἓ	hè
ὠ	ō
β̓	b̓
ψ̓	ps̓
Ἁ	Ha
ῗ	ï̂
Ὕ	Hú
ῂ	ḕi
Ἅ	Há
ῷ̓	ôi̓
ῦ̓	û̓
ᾕ	hḗi
ὐ	u
Ὤ	Ṓ
ό̓	ó̓
ᾦ	ôi
Ἆ	Â
Ὧ	Hô
ἠ	ē
ὀ	o
ἒ	è
ῤ̓	r̓
ᾑ	hēi
ἀ	a
Ψ	Ps
ῶ̓	ô̓
?	?
ʽ̓	ʽ̓
ᾴ	ái
Π́	P̓
~	̂
´	́
ψ́	ps̓
π͂	p̂ 
ϝ	v
Ἦ	Ê
ὀ͂	ô
Ὡ	Hō
Ὥ	Hṓ
ᾍ	Hái
῎	́
῞	h́
αἷ	haî
αἳ	haì
αἱ	hai
αἵ	haí
Αἱ	Hai
Αἵ	Haí
οὗ	hoû
οἳ	hoì
οἱ	hoi
οἵ	hoí
οἷ	hoî
οὓ	hoù
οὑ	hou
εἷ	heî
εἵ	heí
εὗ	heû
εὑ	heu
εἱ	hei
υἱ	hui
υἷ	huî
